#############.######
####.########.######
####.########.######
####.########.######
####........#.######
###########.#.######
###########.#.######
###########.#.######
###########.#.######
######......#.######
######.######.######
######.######.######
######........######
####################
####################
